
#################################################################
#                                 #                             #
#                              #  ##################            #
#                              #          #$#     #             #
#                              #       #  # #  #  #             #
#                              #  ######  #$#  #  #             #
#                   @          ######  #  # #  #  #             #
#                                      #  $    #  #             #
#                                     ##########  #             #
#                                        $ $  $   #             #
#                                   ############  #             #
#                                                 #             #
#                                   ###############             #
#                                                               #
#                                                               #
#################################################################